##############################
#...##..##..##.....##........#
#...##..##...............##..#
###.##..##..##.....##....##..#
###.##.###...#.....##.....#..#
#...##.#####.############.####
#...##..####.############.####
#...##..##...#.....##........#
#...##..##..##.....##..##....#
##.####.##.........#########.#
##.####.####.###############.#
#...##..####.########...##...#
#...##..##.....##..##........#
##.###..##.....##..##...##...#
##.####.##..@......#########.#
#...###.##.....##..#########.#
#...##..##.....##..##...##...#
#.......######.##.###...##...#
#...##..######.##.###...##...#
#...###.##.....##..##........#
###.###.##.....##..###.#######
###.##.........##..###.#######
#...##..##.....##..##..##....#
#...##..##.....##..##........#
#.############################
#.############################
#..........##..##..##........#
#.....##...........##...##.$.#
#.....##...##..##.......##...#
##############################