##############################
#............##...##.##...##.#
###.#######.####.###.##...##.#
###.#######.####.###.##...##.#
#.....##.##..##......##.####.#
#..##....###.##...##.##.#....#
##.#########. ....##.##...##.#
##.########..##...##.##...##.#
#........###.###.###......##.#
########.###.###.###.####.##.#
########.##..##...##.####.##.#
#........##..##...##.##...##.#
#####.########################
#####.########################
#............................#
###########.##################
###########.##################
#......##.#....##..##...##...#
#..##.....##.................#
#..##..##.############.#######
#..##..##....#########.#######
#####.######.##..##..#..##...#
#####.######.##.........##.@.#
#.##......##.....##..##......#
#.##.##...##.##..##...#.##...#
#.#####.#############.########
#.#####.#############.########
#.##..#...##.....##.#....##..#
#.........##..##.............#
##############################