########################################
#.....##............##.................#
#.....##...............................#
#.....##.....................##........#
#...................##.......##........#
#...................##.......##........#
#.....##............##.......##........#
#.....##............##.......##........#
#.....##............##.......##........#
#.....##............##.......##........#
#.....##............##.......##........#
#.....##............##.......##........#
#.....##............##.......##........#
#########################..#############
#########################..#############
#.......##......##.....................#
#...............##.....................#
#...............##......##.............#
#.......##...@..##......##.............#
#.......##..............##.............#
#.......##..............##.............#
#.......##......##......##.............#
#############..###########.............#
#############..###########.............#
#....##........#........##.............#
#.............##........##.............#
#.............##........##.............#
#....##.......##........####..##########
#....##.......##........####..##########
#.$..##.......##........##.............#
#....##.................##.............#
#....##.................##.............#
#....##.......##........##.............#
#....##.......##........##.............#
##################################..####
##################################..####
#................##..........##........#
#......................................#
#...........##.........##..............#
########################################