##############################
#...##........##.......##....#
#...##........##.......##....#
#...##........##.......##....#
#...##...$....##.......#####.#
#...##........##.......#####.#
#.............##.......##....#
#...##........##.......##....#
########.#########.######....#
########.#########.###.......#
#........##...##.......##....#
#........##.@.##.......##....#
#........##...##.......###.###
#........###...........###.###
##.#########.###.......##....#
##.########...##.......##....#
#........##...##.......##....#
#........##...#######.###....#
#.............#######.###....#
#####.#####...##.......##....#
#####.#####...##.......##....#
#........##...##.......##.####
#........###.###.......##.####
#........###.######.#####....#
#........##...#####.#####....#
#........##...##.......##....#
#........##...##.......##....#
#........##...##.......##....#
#........##...##.......##....#
##############################